#############
#############
#############
#############
#############
#############
#############
#############
#############
#############
#############
#############
#############
#############
#############
#############
#############
#############
#############
#####.#######
#####-#######
#####.#######
#####-#######
#.|.|.#######
#-###-#######
#.###.#######
#-###-#######
#X###.|.#####
#############
