#############
#.###########
#-###########
#.###########
#-###########
#.###########
#-###########
#.#########.#
#-#########-#
#.#########.#
#-#########-#
#.#########.#
#-#########-#
#.#########.#
#-#########-#
#.#########.#
#-#########-#
#.|.|.|.|.|.#
#-###########
#.###########
#-###########
#.###########
#-###########
#.###########
#-###########
#.###########
#-###########
#X###########
#############
