#############
#.|.|.|.|.|.#
#-#####-###-#
#.#.|.#.#.#.#
#-#-###-#-#-#
#.#.#.|.#.|.#
#-#-#-#####-#
#.#.#.#X|.#.#
#-#-#-###-#-#
#.|.#.|.#.#.#
###-#-###-#-#
#.|.#.|.|.#.#
#############
