#############
#############
#############
#########.###
#########-###
#####.|.|.###
#######-#-###
#######X|.###
#########-###
#####.|.|.###
#######-#####
#######.#####
#############
