#############
#############
#############
#############
#############
#############
#############
#############
#############
#############
#############
#############
#############
#############
#############
#############
#############
#############
#############
#####.|.|.###
#####-#######
#####.#######
#####-#######
#.|.|.#######
#-###-#######
#.###.#######
#-###-#######
#X###.|.|.###
#############
